NO textures/stone.xpm
SO textures/stone.xpm
WE textures/stone.xpm
EA textures/stone.xpm

F 255,0,255
C 0,255,255

11111
10001
10001
10001
10001
10001
10001
10001
10W01
11111