NO textures/stone.xpm
SO textures/yellow.xpm
WE textures/blue.xpm
EA textures/pink.xpm

F 255,0,255
C 0,255,255

11111
10001
10001
10001
10001
10001
10001
10001
10001
10001
10001
10001
10001
10001
10001
10001
10001
10001
10001
10001
10001
10001
10001
10001
10001
10001
10001
10001
10001
10001
10001
10001
10S01
11111