NO textures/image.xpm
SO textures/green_texture.xpm
WE textures/pink_texture.xpm
EA textures/yellow_texture.xpm

F 255,0,255
C 0,255,255

         1111111111111111111111111
         10000000001100000000001
         10110000011100000000001
         10010000000000000000001
111111111011000001110000000000001
100000000011000001110111111111111
11110111111111011100000010001
11110111101111011101010010001
11000000110101011100000010001
10000000000000001100000010001
10000000000000001101010010001
11000001110101011111011110N0111
11110111 1110101 101111010001
11111111 11111111111111111111