NO textures/stone.xpm
SO textures/stone.xpm
WE textures/stone.xpm
EA textures/stone.xpm

F 255,0,255
C 0,255,255

         1111111111111111111111111
         10000000001100000000001
         10110000011100000000001
         10010000000000000000001
111111111011000001110000000000001
100000000011000001110111110111111
11110111111111011100000010001
11110111101111011101010010001
11000000110101011100000010001
10000000000000001100000010001
10000000000000001101011000001
11000001110101011111010000N0011
11110111 1110101 101111010001
11111111 11111111111111111111