NO textures/stone.xpm
SO textures/yellow.xpm
WE textures/red.xpm
EA textures/green.xpm

F 255,0,255
C 0,255,255

         1111111111111111111111111
         10000000001100000000001
         10110000011100000000001
         10010000000000000000001
111111111011000001110000010000001
100000000011000001110111000111111
111101111111110111000000101000001
11110111101111011101010000000001
11000000110101001100001010101001
10000000000000000000000000000001
10000000000000000000000000000001
1000000000000000000000000N000001
10000000000000001101000000000001
1100000111010101111101000000111
11110111 1110101 101111010001
11111111 11111111111111111111